Únidad 1: 
current: actual, corriente(eléctricidad), corriente de ola
dehydration: Desitratación
As long as: Siempre y cuando, mientras, tan largo como.
set way: Inflexible
Deadline: fecha de entrega, vencimiento, fecha limite
complain: quejarse
accur: ocurrir
in charge: a cargo, responsable
spicy= Picante
aside = a un lado, APARTE
vineyard= viña
scuba diving= buceo
track = hipódromo
gossip = chisme
maternity leave = incapacidad por maternidad
settle = resolver, llegar a un acuerdo
get settled = (informal) acomodarse en un lugar
fluent = hablar con fluidez
cruise = crucero
brief = breve
succint= breve, conciso
hardworking= trabajador
easygoing = fácil de llevar
micromanage = controlar de forma excesiva
sensitive = alguien sensible
charming = encantador, fascinante, cautivador
vain = vanidoso
get along(informal) = llevarse bien
talkative = hablador,parlanchin
humble = hʌmbəl = humilde, modesto
assurance = əˈʃʊərəns = garantía, certeza, seguridad
behave = bɪˈheɪv = comportarse
lightning = laɪtnɪŋ = tormenta